w w w w w w w w w w w w w w w w w w w w w w w w w w w w w w
w c c c c c c c c c c c c c c c c c c c c c c c c c c c m w
w c w w w w w w w w w w w w w w w w w w w w w w w w w w c w
w c w c c c c c c c c c c c c c c c c c c c c c b c c w c w
w c w c w w w w w w w w w w w c w w w w w w w w w w c w c w
w c w c w m c c c c c c c c c c c c c c c c c c c w c w c w
w c w c w c w w w w w w w w w w w w w w w w w w c w c w c w
w c w c w c w c c c c c c c c c c c c c c c c w c w c w c w
w c w c w c w c w w w w w w w c w w w w w w c w c w c w c w
w c w c w c w c w c c c c c c c c c c c b w c w c w c w c w
w c c c w c c m w c w c c c c w c c c w m w c m c w c c c w
w c w c w c w c w c c c c c c c c c c c c w c w c w c w c w
w c w c w c w c w w w w w w w c w w w w w w c w c w c w c w
w c w c w c w c c c c c c c c c c c c c c c c w c w c w c w
w c w c w c w w w w w w w w w w w w w w w w w w c w c w c w
w c w c w b c c c c c c c c c c c c c c c c c c c w c w c w
w c w c w w w w w w w w w w w c w w w w w w w w w w c w c w
w c w c c c c c c c c c c c c c c c c c c c c c c c m w c w
w c w w w w w w w w w w w w w w w w w w w w w w w w w w c w
w m c c c c c c c c c c c c c b c c c c c c c c c c c c c w
w w w w w w w w w w w w w w w w w w w w w w w w w w w w w w
