w w w w w w w w w w w w w w w . w w w w w w w w w w w w w w
w m c c w w w w w w w w c c c m c c c w w w w w w w c c c w
w c w c c c c c c c c c c w w c w w c c c c c c c b m w c w
w c w c w c w w w w w w c w w c w w c w w w w w c w c w c w
w c w c w c w w w w w w c w w c w w c w w w w w c w c w c w
w b c c c c c c c c c c c c c c c c c c c c c c c c c c c w
w w w c w w c w w w w c w w w c w w w c w w w c w w c w w w
w w c c c c c c c c c c w w w c w w w c c c c c c c c c w w
w w c w w w c w w w w c c c c b c c c m w w w c w w w c w w
w w c w w w c w w w w c w w w w w w w c w w w c w w w c w w
. c c c c c c c c c c c c c c c c c c c c c c c c c c c c .
w w c w w w c w w w w c w w w w w w w c w w w c w w w c w w
w w c w w w c w w w w c c c c c c c c c w w w c w w w c w w
w w c c c c c c c c c c w w w c w w w c c c c c c c c c w w
w w w c w w c w w w w c w w w c w w w c w w w c w w c w w w
w c c c b c c c c c c c c c c b c c c c c c c c c c c c c w
w c w c w c w w w w w w c w w c w w c w w w w w c w c w c w
w c w c w c w w w w w w c w w c w w c w w w w w c w c w c w
w c w c c c c c c c c c c w w c w w c c c c c c c c c w c w
w c c m w w w w w w w w c c c c c c c w w w w w w w c c m w
w w w w w w w w w w w w w w w . w w w w w w w w w w w w w w